-------------------
|                 |
| |     ||| ||||| |
| |||||     ||||| |
| ||||| ||||||||| |
|    |||    |   | |
| || |||  | | | | |
| |  |||||| | | | |
| | ||||||| | | | |
| | |||   | | | | |
| | ||||| | | | | |
| | ||||| | | | | |
| |    || | | | |||
  |||| || |   |    
| |  | || ||| |||||
|    |            |
| |  |||||||||| |||
|           ||| |||
-------------------
